12
31
&&&&&&&&&&&&&&&&&&&&&&&&&&&&&&
#````````````````````````````#
#````````````````````````````#
#````````````````````````````#
#````````````````````````````#
#````````````````````````````#
#````````````````````````````#
#````````````````````````````#
#```````````````````````/\```#
#````````````````````````````#
#````````````````````````````#
&&&&&&&&&&&&&&&&&&&&&&&&&&&&&&
