#################################
########@@@######@@@#############
#######@###@####@###@############
######@#####@#@######@###########
#####@#######@########@##########
#######@############@############
#########@########@##############
##########@#####@################
############@#@##################
#############@###################
#################################
