12
31
&&&&&&&&&&&&&&&&&&&&&&&&&&&&&&
#```````````````````#````````#
#```````````````````#````````#
#```````````````````#````````#
#```````````````````#````````#
#``````````#`````````````````#
#``````````#`````````````````#
#``````````#`````````````````#
#``````````#`````````````````#
#``````````#`````````````````#
#``````````#`````````````````#
&&&&&&&&&&&&&&&&&&&&&&&&&&&&&&
